8,15
W,W,W,S,W,W,W,W,
W,P,P,P,P,P,W,W,
W,P,P,P,P,P,W,W,
W,P,P,P,P,P,W,W,
W,W,W,D,W,W,W,W,
W,P,P,P,P,P,W,W,
W,P,P,P,P,P,W,W,
W,P,P,G,P,P,BL,E,
W,P,P,P,P,P,W,W,
W,P,P,P,P,P,W,W,
W,W,W,D,W,W,W,W,
W,P,P,P,P,P,W,W,
W,P,P,BK,P,P,W,W,
W,P,P,P,P,P,W,W,
W,W,W,W,W,W,W,W,
