8,15
W,W,W,W,W,W,W,W,
W,P,P,S,P,P,W,W,
W,P,P,P,P,P,W,W,
W,P,P,P,P,P,W,W,
W,W,W,D,W,W,W,W,
W,P,P,P,P,P,W,W,
W,P,P,P,P,P,W,W,
W,P,P,SG,P,P,BL,E,
W,P,P,P,P,P,W,W,
W,P,P,P,P,P,W,W,
W,W,W,D,W,W,W,W,
W,P,P,P,P,P,W,W,
W,P,P,BK,P,P,W,W,
W,P,P,P,P,P,W,W,
W,W,W,W,W,W,W,W,
