6,13
W,W,W,W,W,W,
W,P,P,P,W,W,
S,P,BK,P,YL,E,
W,P,P,P,W,W,
W,W,BL,W,W,W,
W,P,P,P,W,W,
W,P,RK,P,W,W,
W,P,P,P,W,W,
W,W,RL,W,W,W,
W,P,P,P,W,W,
W,P,YK,P,W,W,
W,P,P,P,W,W,
W,W,W,W,W,W,
